"filename", "language", "Python", "Database", "YAML", "comment", "blank", "total"
"c:\Users\Sherl King\Desktop\FKBB84_新引理\__init__.py", "Python", 0, 0, 0, 0, 1, 1
"c:\Users\Sherl King\Desktop\FKBB84_新引理\codes\__init__.py", "Python", 0, 0, 0, 0, 1, 1
"c:\Users\Sherl King\Desktop\FKBB84_新引理\codes\main.py", "Python", 22, 0, 0, 2, 2, 26
"c:\Users\Sherl King\Desktop\FKBB84_新引理\codes\main_debug_vsrun.py", "Python", 11, 0, 0, 4, 2, 17
"c:\Users\Sherl King\Desktop\FKBB84_新引理\codes\main_graph_lem1.py", "Python", 11, 0, 0, 3, 2, 16
"c:\Users\Sherl King\Desktop\FKBB84_新引理\codes\runs\__init__.py", "Python", 0, 0, 0, 0, 1, 1
"c:\Users\Sherl King\Desktop\FKBB84_新引理\codes\runs\graph.py", "Python", 46, 0, 0, 1, 8, 55
"c:\Users\Sherl King\Desktop\FKBB84_新引理\codes\runs\graph_lem1.py", "Python", 38, 0, 0, 1, 8, 47
"c:\Users\Sherl King\Desktop\FKBB84_新引理\codes\runs\optimizer.py", "Python", 39, 0, 0, 0, 5, 44
"c:\Users\Sherl King\Desktop\FKBB84_新引理\codes\runs\simulation.py", "Python", 78, 0, 0, 2, 10, 90
"c:\Users\Sherl King\Desktop\FKBB84_新引理\codes\runs\sql_exe.py", "Python", 46, 0, 0, 0, 11, 57
"c:\Users\Sherl King\Desktop\FKBB84_新引理\codes\runs\startpoint.py", "Python", 14, 0, 0, 6, 2, 22
"c:\Users\Sherl King\Desktop\FKBB84_新引理\codes\utils\Edgeworth_expansion.py", "Python", 21, 0, 0, 10, 13, 44
"c:\Users\Sherl King\Desktop\FKBB84_新引理\codes\utils\__init__.py", "Python", 0, 0, 0, 0, 1, 1
"c:\Users\Sherl King\Desktop\FKBB84_新引理\codes\utils\calculated_percentiles.py", "Python", 12, 0, 0, 1, 1, 14
"c:\Users\Sherl King\Desktop\FKBB84_新引理\codes\utils\keyrate copy.py", "Python", 499, 0, 0, 23, 66, 588
"c:\Users\Sherl King\Desktop\FKBB84_新引理\codes\utils\keyrate.py", "Python", 499, 0, 0, 18, 66, 583
"c:\Users\Sherl King\Desktop\FKBB84_新引理\codes\utils\keyrate_CP copy.py", "Python", 45, 0, 0, 4, 6, 55
"c:\Users\Sherl King\Desktop\FKBB84_新引理\codes\utils\keyrate_CP.py", "Python", 51, 0, 0, 3, 11, 65
"c:\Users\Sherl King\Desktop\FKBB84_新引理\codes\utils\lemma1.py", "Python", 121, 0, 0, 65, 30, 216
"c:\Users\Sherl King\Desktop\FKBB84_新引理\codes\utils\optimize.py", "Python", 62, 0, 0, 2, 9, 73
"c:\Users\Sherl King\Desktop\FKBB84_新引理\codes\utils\probabilities.py", "Python", 8, 0, 0, 0, 0, 8
"c:\Users\Sherl King\Desktop\FKBB84_新引理\codes\utils\progress_bar.py", "Python", 8, 0, 0, 0, 1, 9
"c:\Users\Sherl King\Desktop\FKBB84_新引理\codes\utils\response_rate.py", "Python", 68, 0, 0, 15, 11, 94
"c:\Users\Sherl King\Desktop\FKBB84_新引理\codes\utils\sampling.py", "Python", 9, 0, 0, 0, 0, 9
"c:\Users\Sherl King\Desktop\FKBB84_新引理\conf\__init__.py", "Python", 0, 0, 0, 0, 1, 1
"c:\Users\Sherl King\Desktop\FKBB84_新引理\conf\config1.yaml", "YAML", 0, 0, 30, 0, 2, 32
"c:\Users\Sherl King\Desktop\FKBB84_新引理\conf\config1_1.yaml", "YAML", 0, 0, 30, 0, 2, 32
"c:\Users\Sherl King\Desktop\FKBB84_新引理\conf\config2.yaml", "YAML", 0, 0, 30, 0, 2, 32
"c:\Users\Sherl King\Desktop\FKBB84_新引理\conf\config_lemma_test.yaml", "YAML", 0, 0, 33, 11, 3, 47
"c:\Users\Sherl King\Desktop\FKBB84_新引理\conf\config_new.yaml", "YAML", 0, 0, 31, 0, 2, 33
"c:\Users\Sherl King\Desktop\FKBB84_新引理\databases\config1.db", "Database", 0, 166, 0, 0, 0, 166
"c:\Users\Sherl King\Desktop\FKBB84_新引理\databases\config2.db", "Database", 0, 219, 0, 0, 0, 219
"c:\Users\Sherl King\Desktop\FKBB84_新引理\databases\config3.db", "Database", 0, 21, 0, 0, 0, 21
"c:\Users\Sherl King\Desktop\FKBB84_新引理\databases\config4.db", "Database", 0, 21, 0, 0, 0, 21
"c:\Users\Sherl King\Desktop\FKBB84_新引理\databases\config5.db", "Database", 0, 20, 0, 0, 0, 20
"c:\Users\Sherl King\Desktop\FKBB84_新引理\databases\config6.db", "Database", 0, 21, 0, 0, 0, 21
"c:\Users\Sherl King\Desktop\FKBB84_新引理\databases\config7.db", "Database", 0, 22, 0, 0, 0, 22
"c:\Users\Sherl King\Desktop\FKBB84_新引理\databases\config_lemma_test.db", "Database", 0, 160, 0, 0, 2, 162
"c:\Users\Sherl King\Desktop\FKBB84_新引理\databases\config_new.db", "Database", 0, 250, 0, 0, 3, 253
"c:\Users\Sherl King\Desktop\FKBB84_新引理\databases\config_new_bk.db", "Database", 0, 229, 0, 0, 2, 231
"c:\Users\Sherl King\Desktop\FKBB84_新引理\root.py", "Python", 2, 0, 0, 0, 0, 2
"Total", "-", 1710, 1129, 154, 171, 287, 3451